Codon	HeLa_IsOpt
GCA	Opt
GCC	Opt
GCG	NonOpt
GCT	Opt
TGC	NonOpt
TGT	NonOpt
GAC	Opt
GAT	Opt
GAA	Opt
GAG	Opt
TTC	Opt
TTT	Opt
GGA	Opt
GGC	Opt
GGG	Opt
GGT	Opt
CAC	Opt
CAT	Opt
ATA	NonOpt
ATC	NonOpt
ATT	NonOpt
AAA	Opt
AAG	Opt
CTA	NonOpt
CTC	NonOpt
CTG	Opt
CTT	NonOpt
TTA	Opt
TTG	Opt
ATG	Opt
AAC	Opt
AAT	NonOpt
CCA	NonOpt
CCC	NonOpt
CCG	NonOpt
CCT	NonOpt
CAA	NonOpt
CAG	NonOpt
AGA	Opt
AGG	Opt
CGA	Opt
CGC	NonOpt
CGG	Opt
CGT	Opt
AGC	Opt
AGT	NonOpt
TCA	Opt
TCC	NonOpt
TCG	NonOpt
TCT	NonOpt
ACA	NonOpt
ACC	NonOpt
ACG	NonOpt
ACT	NonOpt
GTA	NonOpt
GTC	NonOpt
GTG	Opt
GTT	NonOpt
TGG	NonOpt
TAC	NonOpt
TAT	NonOpt